8 8
........
........
..###...
..#+#...
..#.#...
..#.#...
.....@..
........