8 8
........
........
.....#..
..#..#..
..#..#..
..#..#..
+.#.....
.@......